hgm: krj psx xsl bpt
pgz: mhs rsb mvk jjz
ckf: nmv mvc
qhd: fgp hmt nvs
hsz: mjb dtr rkg
nrt: krr
kzj: xkf xct pjf nzt
rhj: kck
phg: hsr qcc
knc: cgn
ncc: kjm jmd
dgg: fxm
qkj: lbz gfc ssf tjn
ccc: cbs ksm gdb
btf: sjx sck ndc hgr
kxz: fgq hjv hdq ssk
gmr: mlz rkk ltt qzq
kpb: ckp dsj tqh nhv
qbm: tkm lrr
dsj: fmn dps
rbj: qhh mqd zbj dld
krj: vvm
jlv: zct lpr prj ztc
htm: qhk
tgf: gst xhn ppm
nmv: tpx
rfs: xxs nrt
mkt: gvv dtp chh
hgr: lnv cbq zrb
mqb: mvc tjp fct
qlx: gjx kcp tpx
dsr: dmj ntc xdn
xtv: jgn zpk
trz: xhn qqr lhr
xmq: rhj
dvh: jtt pvq
ghr: rcc xct czt mlq
bbd: sfm lzr cqq
sxr: snl jtv
cxk: lnv vbb qdc ljf rzk
cbq: shf cqv
svp: nmm lzc plz
xbn: rsl qnh
bsd: cgn
gtt: hmt
zrk: ckv
gds: hdh
ncx: nlk
nck: qhf
qcf: gst kgq
mdc: mdf bvb
ppb: nrg txc znd vlm
rxg: zng msc pmk
rxk: dgc qmr cbj
cdt: mcm vhc drb mrm
zqm: zgs gvr bnd clb
njh: rdk qbd
ktn: fpm
vrp: dch cpf prn xcz
jdp: hsx sbh jjz jxj nlx rhj
tfm: lvz
lkl: bzk rdk nzm
nlx: jsc dgc
pgl: kql plh ctn nsg
ndl: fcq fqz
nqn: bpl bmj rdm
jtf: vgr hmj
hmz: xtq bmd
bhm: jmd hst dvd
jpc: jzk zvs
krq: mst lqx
kbx: tbs
lfx: rnm lrn
cbb: nvs
msh: lgq txb bnq nzm
hxm: vnr
ljf: jxr vql
sdx: txc
xkp: xcf btq gfc dmx jpp
spl: kvn fzf bqz tcm
fbc: zgl ztc crm bnd svx nrc mrk
zdx: dlj
bbz: plz kgb czq
pnz: tjp nvb
jhn: kds kqr
hss: fth mmr cbc dpb nxk
dqg: vhl rqv
lhz: jjv rqv
sbr: zxz trz vsg lbz
dld: vgr
smf: rvm qhl rdk mlf
znx: rfn mrv
skl: klt vmc hts lzr
xzz: dlz bqs nvj vpl bpx fqs sqj
sbg: fvf jsk zvv sxr
ngn: czt
fhm: hkk smr vhc
khp: pxm bkj glc cvz
tks: xnf
fgl: jhn
nzm: qxt gng
gpm: fcq llj hmh
ckx: hsr cmb ncn krc
lrh: ssd
qpn: vnr
vvv: tgb tmm rfc tlt xtj lsv
tdt: bvr gnt vql
qxx: krr
pvb: dmh ths msg hgq
qst: vcq
vzp: knc
xjn: gds
kvn: hmj
mjf: nxz
njc: gpt bhm ghh
gmc: mcd trp vxv
rxx: zbc ncn rxc
nrg: hkr bcx jnh
qzq: bqg
hxt: rtp dkn sbn zjb tks
mjx: tgb
jvf: bxc
cnx: gvr
tjp: mcv cnq
qch: sbz vgz pcb
fcp: nxv vfq pfl
zxj: mjf hrj gzc rkl mbs
hnd: rfm mbs vxv fhn
snn: xns xzx vpm bcv vvm
gbq: hnz bzd rps
fjn: cbb vqq dtx fsg
dxf: lxz snv
bhc: shr lpf bbd
kzn: sxm dnz gtq
hgp: ppm
ctn: qzh lnj
rks: hfq fsb dhb
xvr: thn xhs mdc nmr
hqp: lqj zxm
zmg: cxz gcx cqq
ccs: gvr
vbp: vdt plz bhq cgn
sls: xbl qpn khb
nnj: plh
fct: tlt
dmv: rbg xgq fqz fnc
bfr: sbz zmq
vpd: sxm njm qtx
scr: zps
fcj: rgl xgj ddt
dgx: vhl fhg gsx
vrv: gtt fhp rks
ttx: vrh std lfx mvz
hgk: xsv bqg bfr kjr tvk
lht: vcq jzk
nxs: gqh kfr
xtk: jsk ghh
mjb: xct xsh stt crm slf xkc llz
cdk: krr xkf
cmb: rpd
qgv: lcb gpv
cjn: dsr rlc lsz mtp
gvv: vbq qfb cft
xdk: mft hff pxs
vrh: dmh
dpb: hgp
xsh: rfn
jtk: nmh zmk
vdl: gfq chx fxm xdf
qqr: hrt mcd
hlz: hbv lbv ccc ckf
qmz: bsg nkt
nbt: dgg nrl klt txj nlf
jdn: mth gms bxc
kjm: msc
vjb: hsh msg hlq ddd tvz
vsg: mft gzc zng
rbm: mmf vrl djl czd
vpc: jfq jcp rhr vpg
ghh: jsk
qpb: qts fbj
zkj: mvc nbx bzb cpf
hkk: kcp qql mlz
qdg: srj psr fvh qsz dnn
css: tpn cmf mjx
skd: jcm
hnn: gcr hln zgk bzb
msc: xcf dpr
kqh: czz fvh dxf msn
hql: slf vtt
cnt: rqx vxv
mrm: bdn pmt cdq
gbb: nrt bsv
xrv: rcj zbc tpj cjq
vqs: dsm str rvv gfb
zqq: lmc zvv
qbs: klv jrb txs mmr
snb: gcz ctp
xbz: qts rdk kzz
cph: rqv
msn: mcd mxr mhl
dth: lfd gvr hdk rpd
tpn: jqj fxm
gpr: drb xpj nlz dkn
pqj: dbz tqc lht
xns: ttr rnm vgz
lss: vcq zzd bkj mqn
tlg: kxl nml zvh
kvj: mnx gms rgj njv
gqk: ppl rtp
tqc: vvg
vmj: vrl zjb vlf sft lnl dkn
scb: zmv cqv fzz vff
gpv: zps ktn
shf: clb
llf: xrq
qcq: gkh cpf sft
drf: vzt hsz xxs bxl mmn
zjm: sth cph nxs
nfm: hvd pgl qhk lmv
lrz: mcv fql
hmb: dsj crg tqh
zjr: vcf zqh
xdn: ppm sml cjq
tbn: sjk
vpg: cqb fng tvk lpb
jcl: thn dln pxn spx gfh
txj: lrh gmt jcm
kql: rkk qps
hsx: cmb
nkv: mjf nkt bxb
tqr: mjf gbz xnc kds
zdh: fvh vbb rks sbr
ldq: lpr jxr
fgc: fjs hxx qch jtk
bzl: rxv njm knh
mtl: qgq bzb xxp cfh
qvv: vhl ltt
hxx: cnq ntz ctn
mst: vtq
rxc: rlc bdd
vql: lmc
mhr: mxr fkt nlx qpt dqd bkm
bqf: czq sdq xjk njh
bvr: mmb
cfh: qch dpk ssd cqr
mlf: xqg xqk mhs
sks: czd lpf vrp rpx
qtx: drp zcq
jmh: ctn tkd mst gdq
dvd: frs hrt
fjk: fxm hqd tbj
qtv: mxp
kxj: vrh hmf rhc ttr
czs: dlk ntg gds
chk: drb kvn tqc xmk
bpr: xsh
nct: fzq bnp
zjp: xcz hxt xdf
xtb: zfm lvb pvq pnz
zfz: mkj lfd fsb
dqd: qkt
tpk: nqd mjb kxp fvz
lzr: sbc
fxb: csh gpm nsx blc pfv
nnv: hkr ktc rnm vlm
xsq: pgp lnp cvm qsx knx
ctk: zvs ssk
nkp: tgv cfv xxt
fhx: hff gbz
hcv: fmz jmh sfm
cqt: xkl zbc xgj
gfc: bgm
pkn: bxs gzc jhn fdc
cdq: spx
pnc: rcx ghh
plk: hff fkf
ffc: zxm vzt
gxz: qvx rzk
mpr: lxz
bkj: lcb
nhd: xln mrv
vlf: mdf
mqd: hnz dfg
lrr: cpf
xps: krg lvz fsg
drh: kjn qkn gmm xgc
mhc: ntp lzc mmn
kvx: rdd jkj dps bgj ppr ncx
kgv: jgn
xlv: zgv qnp stp bhv kdc nxg
fmz: zjm cgt psx
mhs: xzc cgn rcx
lhr: ptb sjk
qbz: lnj vlh fhg
zvq: rsb mgm vqq lnp vss
xvt: bnk jzf
htx: dld ssk sxf ksn
pxs: ppm
jmt: krr vcf fbj dpb qkd
bnd: ckv jgn
vdt: mhl crz ggj xgj lvz
sdl: khc nlk fvc
dgf: xbl vmc nct
zvs: kzs vzq qtv nmh
nmr: qll sxf bzh
zsq: tjn
tjm: gdq vnt jtd ktn
mlq: vnb rcc ppr
tft: kpc gds xzx gbq
rhs: kds sdl rnd fbh xkc
hdq: pzr mbq pfv
vnx: fvc mgm kkc zfz
jzn: lpn lqb
rkz: pml svx nxz
zjb: cph zmq ssd
prf: trp qrp
czk: vph dsk nxg zcl
pfh: ggs tnk bjb dsm
tmq: rth cxq dvb rzp
xzm: qtx snv
kqc: ppl fhg
jgf: vnt fbt zxk pqj fmd
rpd: bpr
jrp: ddt rfm xsn
nnh: tbb vmc rpj
stx: ddf sxc mvz fhg cls
zdn: hbl pzt
pvh: tnk ncj
xtj: zps
blg: llz lhr
jhc: ssf mxz qlz
mnx: kqc zmt tbj
jxm: dnz zbx qhf lhv
ndc: ssx jvr xln
nrc: grc mrk
pxn: rvv
glq: tbs
qvz: tkd hxm qmd sdx
dqv: hnm gtv rxx gkx zcq zmv
rjg: plh hvd jmr bdn
trc: vvg mjx bcl skn
hhj: qpb jjz drp
khb: tbj str
sjh: bfz xhk zgk xnf
cfv: zgj
nfg: xhf prk jgn hdf
vtf: nsx bqz lvb
nmf: cfv xsv mgd
hzk: tlp pcb dkr qpn czs
qrp: zgl
rps: khb gss gjx
ksv: qbd hxk
fhn: khc hfq
zcz: xdf kdg
ldz: kpc msg fcp xhm
xbl: glc vtq ctx
lcv: dtp rgs xgf sbh
pfz: zbq
vkd: tdt cnt nqn fvh
mmn: gst
xtl: tns zkf lxh xdk
rdk: kck pjf qlt
gjg: fgl ppm
hqd: vgj zgt
ckz: nqp dvg
qkd: ssx
jjz: czt
gfh: rnb drb
fvf: zbz
bgh: qrp pzt
bfm: bgq
nhv: bpr vmk hsr
dnd: fql hsh
lvb: xtq dvn
bpx: bnk
vhs: dxf hkd djj fsn
bsv: qgz vxv jph
jjt: ldq ckv jvr
vgd: cdf zzc ksm
gll: fpq hsx nkv fkt svb sbg
cdx: qbd jjt fsg
zbp: lvz hnm fdj
ctx: scr
gsx: kzs
shc: qsf
pmp: tct gqk fpm cdf pjp
ctc: vpm lnl zzc fct
tbz: rtd cqb qmm
ssf: vbb
bjv: kjn bsz grj mmn
vkn: zrk nlk mrv ntc
nxn: zqq dvg hll qhl
xjt: krc hfq
mls: fzq mjx src tlp dsm nvb xxm
djl: dgx zdf rpt jcp
dlj: rgp njv
qxc: ktn kdg
zkf: kff xln mcd
xhm: hbv lcb glc
fkf: bxl
thv: ckv tbn dpx qcc
shk: tpx dpl rmf czs rvh
jdd: ctk dgg vmc mvp htm
tkg: cgs vjf zkf krg
ptm: sml qkd tjc sjx mhc
qgm: qfg vfq dkr lsv
prq: kdg mkf rtd
gdf: llj glq jtq
ktb: fbh gcz grc dqp
tkd: vxh dng nmh
vnt: scr
nqp: pvm
xqk: gxz tjn mxr
vrl: rpx ptk
nrd: vmt
vkh: krq hsh dng cfv
cfg: dvn gxx
vnb: nlh cjq llz
mhl: pbt
mzp: qxm bsg hkb kvx
gdq: mlz
srj: cbb zbz hsx
hsj: gfh dfg tft dng dhd
dqx: xxt
fkt: gnt zrb
bpl: dvg fhx
fzx: xtk btq tqh xdm nhd cth
znd: jcp gml ksm
mjj: njm zpk mrd
xxs: dqq
qhl: pvm
dsd: shr kdg
rmf: bqz
bcl: fpm cqq vqr
rvv: bxc kzs
bqs: mjg pnc dsj
dkr: ktd
shm: fpm hck
msg: mth
ckp: xsh
spj: zjf jsn jjv
vzq: rbg pvq
mvp: bnm qqj pzr fhm qcq
pgs: txc vjd zmk
ddd: nxg dch sxc
jtt: hmj
gms: xtj dpk
gcz: fmn xqg fpq
fmp: gnt klm vzt vmf vhv
hrj: xzc
pbt: fth krl
cxq: qbm npr std
fdc: xbz xcf
jkj: plz snl
bdn: qqj
rqv: tlp
ggs: bzh zhd
flg: vvl rfc vjd zkr
zkr: tgd xpj sxc
bxs: snp
gfp: lqh xkm
srd: cvz bdh vcq
kpf: ncx hql nxq jrp
nrn: dqk vvm kxj sft
fxm: tnk
qzs: fns tqg sgn
ptg: hhj gcm rfn
sqc: zbx rnd hrj xzc
zxz: rxk qxx pzt
mgm: bxr qcf
cqr: htt mqn
mmm: kvn spx jvf ntz
jrb: fdj smc
vhc: mmf
nsn: ltt lgk dfg xmc
grj: kmt mmb
xrl: xdm
fmd: jtq ztd
rth: pjp
lbg: cqb jfq prn lrr
vmk: rpd rzk
vsp: nmv zpg vgj zcz
vss: qpb rdm pbt rkz
rgq: qxz zmk qnb zfc
vdh: dtr vtr xmq rfm zbp
smr: ssk
bdh: sgn
hpp: mcv tjl
zqh: xjt
qhn: zsd dgf vdz bdx
sbn: kcp hmh
gvm: nrm smc xrc bbh
jtb: lqb gqk zmt vhr pxn
gss: zfm
vvt: sbz
zcf: zgk njv
prt: cqv sqj lhv nml
sfp: jtf tjp dmv jrn xmc
sbh: bpr bbh
lpn: bfm mnc
qbd: dqq lgq
grc: djn
ztc: kff cdk
pcb: cdf
lqn: jjv tqg srh fzf
kmh: qxt xrc gtq
pdq: ncq qnx jnh
dlg: bzl fgl nrm
bvm: ctp knc zng clv
ssx: xzv
cft: grc
lqb: xnf
plh: zhd
lhv: hnm llz blb
qgz: njm ctp zct
ksj: zbz nqj tbn
cjb: lgm ccs mzx dhb
qdm: lsb sxl mtp mzd
prm: ntg ksm xzx nlf
bxl: rcx khc
stt: vzp ksj
rsb: mpr sjk
dng: fhg
jqx: qvv xmc gfq
rkg: gtv xjh fsn
hmt: fgp
nvb: nzz vvm
kjn: tcj grj
rkn: dsq bzs rtx
qbk: tcj ggb qpt hst
szp: npr dvb spl xpj bnp ptk
dtg: kgq dpx
mtp: ldq
rqx: qsx rpl rnd
gbp: qlt nvg gvp prf
bgq: tlp xzx
nmm: xrl znx bkm
jvr: dtr fbj
drn: xcn zgt xss rgj
zrj: pzr
hkz: xzv qgc vbs kvk
jqk: mxp zjp mlb vmc
dsm: hbv
dch: krj
pkr: xmq mkj bxs xkl fvb
hcz: hgq zrh xsp
jfb: xjk jmd rpd fmn
zgz: vtf htx tcl lhn fzq jcl
dbt: zzk njb djh hdh
dlz: djj xqk qhf
sck: nck xtk rxg lrq
gkx: qkt
cbj: ckp
kkc: fpq bch hll
mcq: txb zxm tpj
ddv: rnb
skz: krl bzs lkl ncx ntp
vhv: tfm fdc njh
hlg: cqt xzm fhn lrq
pjp: rvh
mfc: zpk fkf
hgb: sbn krj hcc mdc
gtp: fgs nsx bnp
lsb: mxz xbz khc
ktc: qzh nnj
qcn: shf njz
ksm: xhk
kxx: hsr mbg pjl
zlb: ncc kzn fbj
xhb: shm mdc gpq tjm gsx
gpt: cft qqk dtg
ggb: ckz dpx fzz
jfv: zlm qps bdn krm
jlz: rhc
klv: dgc crp kgv
lpf: sdx xtq
gfq: lfx
ncq: fct
pmb: qpg kcp xvr qch
sqj: rcx bqs
lsz: gbz xjh ccs bvr
nlv: mjf mgl kff
vtd: xjn tqf tmb tpx zdx
gzf: cxg gcx rmf lgk shc dvn
kvc: qmz tnn fth
nsq: rvm fvz rxg bsz grr
hcn: mlz jsn nrn gds
tjh: csb
bvb: qsf
zjf: vpm rjp jnh hxm
jks: ctk qll ghk hxd
tqf: qfm jcm
zsd: bvb fng llj jnx kpc nmv jzn hqd
dpl: lqh
zmk: ncj
nxv: rhc vqr lnx vxh
kzz: zng
bhj: bmj tph jpp qft dlg zlb zxm
xct: fpk rpl
ztl: cth crz lgq nvn
mnc: ddv
lqr: ntz tbz rth hmz lnq
vgr: lhz
mzx: bnq dpb llf
scv: fgp xfv ffc kvx
hkb: trp nlh tdm gng
bjk: zgj ssd tnk
clt: qlt qsz ncc
kgb: kck lgq
knh: rnd fpq
mbq: vlh xbl cnq
czz: gvm tpq hgp
jlp: nlf sjh rbj cfg
lvx: ptk tkm gxx hmh
vzg: nqj gkx vtt
vsk: dkn fns gfq ntz vrl
dhb: lnv tjn
gqz: zrk xxs lhx hgv
zbt: qcn qpj nhj cbb kff
lzc: trz
dmj: zzh xmq vbb bgj xkf
fvz: dzq
jcg: dmf hts sth fzf
dnn: zxj mhl
fdj: xrx nlh kcq
xvq: nzz dqx qmd fbt
brd: mkt dgs cbq ssx
hxd: zps xxt svh
phn: tjc nkt hll jsc tqh
bsg: jxj rxv
nxg: gkh
hkf: xdm nml mhs
dlc: rgl mqx vmf qmr
ncf: tbj zfc ksn
vck: svb rdk nck nmm
dzr: btq bpg tjc fhx
ddf: hgq
rnl: qxm xdm lvf kzz
smc: gtq
tbb: gqh zll khp nxs gkh
xsb: tgf sdp ckz fdj
bft: lqk tqc xcn ghd
qlq: dtg qtx zvh
gdp: nhj rtr
klm: blb fvf
tqg: zcv
bdd: tfm vtc
cgt: ncq dkn
crz: vql krl gqb
bsk: fpk xrc
ktd: xsv kbx
nvn: bnq sgm rvs
jkx: fgq rnb gfp
gcr: cbs hpp mth dkn
hxk: blb hgp qhl
kcq: vcf
zll: hbv cdq vgr
hgq: jqj
std: ddf dgt xtb kbx
xzv: xrc
prj: qkt
txb: xgf bdl
qqk: vmt xqg
tvc: mqb dmh tbz
fgm: jnx nzz
dcc: jvr plz chh
rzp: qtv dvh
dbz: vph vlf mff dlk
tvk: czd
csh: hkr sbc
vvl: bjk ppl
tgd: mqd
gcx: txc
njz: cjq frs pvm
zxk: pdq zgv
bbh: xrq nvs
hvg: mkj cnx dvg
rvd: crp xrq dpr zbz
hnc: dxf pml
qgq: tqf qnb vtq sdx
frr: dpk fzf vtq
rjp: dln
jhh: zcq rpl
ntl: mbs mbg dzq knx
vlm: hmh vhm vcq
gnr: pxv vtc gtq cbc
kcx: htt hcv bnm sbl zrh
fgs: tkm pck
ksn: rsl shr
qnb: xtj rtd
cth: nhd cjb
rpj: cbs gml xkm
fjf: xtb xns dnd zzd
pfb: qll vnr dvb
xfx: mkf bdn jkx vzq pfb
xrx: gvr qvx lfd
cvm: znx rgl xgc nxk pxv dpb
bqz: dqg gjx vvt
nxq: dvg jsc
fvc: fvg jzf rkl lqj cfd phg dgc
bmd: cqq bfz
cqm: ktd lnx sbc mjx
xnc: jxj
zdf: zcv zfm dmh
fng: qfm
sxf: njv prq zgv
dnl: rxc hvg vss xrl
zpg: ctx shr qzk djh
blc: qhk nbx cls
dpx: bdl
jvz: nmm zjr
qts: sxm
lnp: rpd
xmk: zgd mxt xhk
qfb: tjc fbh zqh
njd: tpj
rzk: mrv
hkd: gst qrp qpj
ddt: rhj
svb: prf dzq rfn
lbv: xhk fcq vhl
zzf: lrr dfg mvz rxm
vfq: bqg ncj
jtd: qll zrh gfb
sjt: lnj mnc qbz rfc
jrn: zcv mkf jtk
mvk: llz rsb
lpb: hmj rtp
ntg: cfv
kvg: prn lgk fqz bkj
hhg: tks xsp pxm qxz
kcf: lgq rdd vpd rvs
gqc: bqs dgs pkr rkn
ssm: fmn krg qsz
pdc: mgl plk
mjq: gbr rjp hlq chx
lzk: lnx cqq
xgc: xhf
xkl: qkt bdl
qms: qfm hgq hts jfq
dgs: kmh pfz qvx
hts: qfm
djh: lnx
thn: zgt
csb: xmq
grn: zvv mcq rnl jvz
gdb: lnj mlz
qcc: drp
xqf: krm dvh vsm xkm
ldb: jhn cxk snp jxb
svx: nxk khc
kzq: rzq jtt
bkm: kgq
rzq: xpj mxt
tcm: dpk xqh
zbj: svh jlz
bnb: ntg jvf pvh lmv
kch: zmt zfm sqv kqc qnl rgp
hpc: qts
cbc: xtv qlt
nlz: hlq fqz
kqs: cmf cls fgm qhk
bjb: zcz lrn xgq
blb: qdc
bfz: rgp zfc
bhv: zrj sls
cbs: gjx
vvg: nrl
pmk: zrb cbj xdm
bzk: krc
vhm: tgv chx kfr
ncn: rvs zzh jpp
jph: lgq snp jzf
bch: nqp
ttr: qmm qtv
kxl: hrt krl xjt
sxl: gjg
lnq: rsl dnd
hdf: hff lgm vzp stt
bcv: tks
nmb: tbs fmd dqg tcm
dsk: dlk mbq qtv
xxt: phs cnn sft
psx: zcf
pcg: sgn nnj hsj tbj
zgd: gxb mdf
zmt: dqx
hst: lqj
krx: qsx mrk
zbx: gmc fgp ntr lxh
xcz: zrj skd
dsq: fcj rdm
fzz: zrb
hkr: zps
jsc: xln
mkj: tpq
dqk: sdx lqh
xxp: glq dlk zmt
gtv: xsh blg qsz
kgq: dqq
svf: hkf pgp zqq fvg
gpq: tjl zpd xcn qzh
mgs: nqd nlk tdv fpk bhq
pck: ddf
dkn: lht
jgl: kzq ggs qnh nzz
rlc: zzh chh rvm lvz
rdm: fpk bpg
ztd: qnx zzc
pfl: sbc qql txj jlz
hln: krm tvk fgq cls
prk: xhf pzt clv
sjs: rfs kvl nlv msn
gvp: pbt nml trz hst hnm
crm: dzq mkb
vff: mgl mxr pfz qlz
dmf: hdh jpc fns
pqc: vnb sxm hpc kqr
gfb: qnx
txp: gbb mkb qkn gcm rsb
ths: dpl gxx kzs
qpg: cph mqn
fnc: lzr tgb zlm
xnd: fvb vrv ccv rmg
xgf: gxz pjf
lnl: pzr llr
kds: pvm
qfz: knc qlz msk njh
hgv: rtr gng
vhr: pck qvv bfr
hdk: phg mtp vzg
tlb: xkc hvg zqh pxv rdk xsn
vvm: qsf
llz: slf
fjt: ssd qst cfg lzr vvt
tcl: rqv bdh
djf: vvl jlz dpl zcl
dcd: bqg ppl mjq htm
kqr: zzb
nvl: klv jxb qcn gcm
zvc: sxr xmq zrk hjr
zlr: clb zdn hvg
pgp: xbz zsq
vlh: tjl
lrq: jsk mkb
zct: qxt bnq
crg: tdv
xhv: dps hst vtr frs
fsb: vzt
njm: qxx
tvz: xhs hlq lqb
gkm: jtt qzq rxm nkp gms
dnr: pgs qnb hck lmv
bgj: bnk nhj
xbb: hcz qzs htt
zfv: sxf cnn dlj
fzq: fbt
krz: hmt tdm xkp hqp
pml: ghh crp
bmj: ljf xgj
cxg: gfp gdf klt
hcd: pjp vph hnz ktc jfq
kjr: kzq nlf chx xqh
vxv: lxh
ccg: ssk nnb qnl jpc hcc
dtd: krx fbq ddm
mjg: kmt kxl
hvd: xjn lqk pcb slh
zmv: tdm gtv
hjr: trh dpr hmb dqp
xrh: rxm jzn tbs bfm
snp: bsd ntr
ftm: ghk jkx qgv srd
rbp: xrv bdd kxx qpt
kqg: qkd rkn qqr cdk
cnq: zlm dpl
nvg: vqf rdk
xjh: fth xhn
qql: vnr mqn
lfq: zjm vfq bdh bhv frr
lnv: knh
knx: bvr qts gtt
gqq: zfc msg gxx phs
xsp: qbm
slh: fhg mvc lqx
nsg: hck dsd ksn qnp
tct: vgz djh
qkn: hql xtv
cqv: jkj
zzt: phs mcv bcl lnx
sdq: nzm fvz dpr
stp: pck nmf vlf ncq
vph: mfc fqz zcf
txs: bgd snl rkl
gqb: fth dtp
qpt: tdm
mbg: mmb ppr
jhz: snb qlq sxl bvm
qzk: lqh phs
tvp: jtk dbz krm tgd gkh qpg
qjb: gfc hpc ckt vrv
mdf: rgp
lpd: xfs cnx phn lvf llf
jmr: prn dch hmj
lmv: skn vgd
mvb: ctx ktd bgq
lhx: qlz vql
qlz: bch
gmt: zkr vhc qzh
bmp: mpr kgv ntp gkx
ntp: chh
bxr: bpl crg
rgj: ltt lqx dpl
dtk: lrz rfc jdn
dgc: snv
fgp: qpj lxh
hll: bgm
bzn: qtv svh pcg vvt
dfh: jjv zdx xhm mff
jfq: mvb qzq zzk
skn: ggs rnb
jmm: lpg kqj xhk tgb
fjs: rzp gbr mvz bcx jnh
mhv: ccv smc bxr ghg gdp hnd
rhc: gfb
sfm: tgv vmt zhd
vpm: nnb
fqp: lbg glq gds zzk
tns: rkl czq mvk mrk kqr
hjv: bxc
vbs: jxb mfc
jdj: mnc shm cvz lmm
nht: zcv zbj rth xkm
kng: llr bdh zrh dkr
vbq: cft qcc
lmm: bvb nmv
rmg: xvt rfn ngc rxv fql
srh: dqg tcl bzh
jtq: bxc qlx
lqk: tbs
grr: fsn bzk ghh zpk
rtx: zlr zcq prj vbq fgp
rcj: bch llf qkt gbz
xss: dqk cxz hjv
jzf: bgm
fhp: snb sgm
bdx: ckf tkm
bzd: qnx chx
lpr: rtr xhn
ddm: njd vmk bsd
sdp: gvm bgm xvt
plr: shc lrh pfh mth zmt
glc: ptk
fsf: tgf zvv xcf ddt
ghd: ndl gss rhc jtf
gsl: lvf fkt tlg lzc
nqd: ksv kjm
fvn: nxk cbb xkp rzc dmx jhh
gcm: tpj
xxm: svh lqk qnl
qfg: tjl gdb css xsp vqr mvb
lbz: qdc xnc
qxz: xjn fng
jrc: hcc fmd zpg dgg
bpg: rpl
mjr: mft ntc bkm rpd crg bbz
zzh: gzc
pvf: dnn xhf hkb ddt zvh
vlk: gcm fvf gtq shf
qmd: cnq vjd
nvs: jsc
qgc: rxg gqb blg
rjn: lzc xps nrd kxx krg
tff: nrl bcv xbn qzk vqr
gzt: nrt ntr
rkv: ngn hqp nxn bnk
cxp: clt zvg csx dsq
pjl: nvg vqf mpr
nzn: cfg nct scr khp
vsm: lmm thk djf
str: fgq zmk
vcf: zng
zpd: ntg fpm tqg
jzk: cfg
dgt: lrh njb
pmt: vlh nmh qxc
rvm: kmt
qnl: mff
qxm: zbc rvs
mkg: lpg bhc rhr bmd
qsm: xqg cnx hgv xfv
xjk: vtt nxz zsq qdc
zvg: gjg hql bmp
qmr: nrm vqf
ckt: bxb tpq qcf
qmm: xmc
mgd: ztd rnm gkh
xcn: sdx jqj
qdh: vnr lhz sbc
blf: fkf plz fsg pxs
cgs: qmz ffc kcq bzk
kfr: qxc
kpc: bzh
kxp: xrq ssm ppm
qnp: tlt skn
xgq: bpt jtt
mlb: gqh klt rvh xsv mmf
czt: ptb
qqj: ncj
tgv: mnc hsh
gsv: dtp lpr dqd mgl nxz
src: vvg mjx chx
xqh: hpp rtd
ghk: fnc rth ctx
slf: cmb
cvz: njb
bsz: nkt lvz ggj
djm: bnq qcf bnk
vqf: csb
lfn: lpb fsv zgk ndl gmt rjp
sqh: nzm nrc fzz sgm
rgs: mmr dps ppr
qpj: ptb
zbq: jxj bsk csb
sbl: dln mkf jzk
bcx: cnn pzr
tmb: qnl ssd fjk
dtx: gzt mft bbh
nml: cbj
xsl: pnz skd jqj
dvb: mxp
lfd: zsq
lsv: nrl rzq
bhq: clb kzz
tph: sjx tpq zrb
xkm: hck bpt
cmf: vrh
qhh: qnx xsp xmc
nsx: cnn zgv
lmr: qhf hnc pxv djn ngn
xhf: xkf
vqd: qhd pkr ngc gnt
dnz: prj
fbh: rtr
lcc: gpv zrh gml zdf
zbc: njd
vxh: gcx rxm
grv: xgq dsm nlz
ngc: rdd xrl
xfv: ntr
bnk: nlh rnd
zbh: trp kxx vdh xzc
cfd: ksv nck slf rfm
cqb: skd zmq
nnb: czd bnp
thk: lzk sgn ckf
fqs: mfc xrq dcc
kpr: spj krq kql nnh
lvf: nxq bsk grc
kvl: vxv nqp gng
vdz: nnj vgj lnq fcq
jxb: xrq
chx: pvq
nqj: mjj pxs plk
sdb: ppl kbx pvh ddv tlt
lmc: ccv
zcb: zlm dgx hxd cnn
vmc: kzs rpt
pcp: hqp zgl hfq dtg
drk: mvc bhc gxk hcc
qvx: qxx
xxq: fhm dmh hmz bnm zgt tpn
kcp: bpt
hbl: mrd plz
qjr: qnh lhz dqx
lgm: fsn svx hsx
zfc: gss tpx
rpx: zgd tlp
ftg: xvq tvz tct cfg kvj
sth: fbt zgj
fsv: qpn ldk qst
tcj: lxz frs
dmx: kzz sjk
cpf: gqh
kdc: qnh cdf kzq
rcc: vtr tjh
glf: csh hxm xhs dvn
bgd: xdm bxb cnt vjf
vtc: mrd
sml: dtp qsx
fvg: zgl pfz
ksk: gdp dvd xsn xzc
zcl: dld zgd
rcl: zbz ngn klm qqk dtp
zxg: lvf mrd fcj csb
psr: hnc vmt
bzb: xtq
hsr: njd
bvv: zvh clv pdc gbb
blx: xfs xsn clv cbq
gng: fsb tjh
vvx: bhc fql vnr jnx
fbq: llz xfv hsr kjm
dhd: kdg gsx vgr
bxb: tdv djn
jtv: qkt ngn kcq
hbh: nck fgl bgh krc
drl: lrz pxn glf qvv
lhn: fgm qdh lqx zfv qgv
jxr: bsk sjx
vjf: lhx kgb
ptb: vtr
lph: shc nrg pxm vpm bzd
hmf: qhk krj njb
pnm: bsd krx njc jrb
zzd: lzk fns ncf
pgc: svp dtd hbl nvj
xfs: knx gzt bxs
gvz: lgk jvf qlx qqj gtp
sqv: xnf xmk vnt
hnz: vgz
rhr: qps xsp
zzc: hjv
lpg: qtv hjv
bhh: ptg krl snv ntc
pjf: lxz
dtr: dqq njm
hsl: rpl snb tpq gkx
rzc: ntr ldb plk tdv
rcz: klv kgv cdx msc
vpl: hpc fbh dnz
rbg: bfm scr mmf spx
ttf: kxx jvz ssf zxg
kbn: mxz vtc fhp vzp mfc
mxt: lvx lrn
shp: ltt psx jms khb
gmm: hrj bpg zdn
rpt: zgj
gxk: ntg qps
bnm: qsf jcm
ldk: dqx lrn grv cgt
nzt: zjr crz hmt
xkn: jqx ggs smr thn
gml: gxx
zvv: rgl
kqj: vhc dgt zmq zmg
hdh: qst
pfv: tkd vvv
qxt: gzc
pnj: xdk jmt zvq xjt
gbr: sbz bvb rmf
tnn: trh bpx rcc
lqj: xnc
kvk: vtt tgf lmc
vgj: llj rsl
czq: mmb
jsn: tgd
zgs: xzv djm djn
cnm: gdq lnx ptk dtk
stn: zxk tvc mff htm
mcm: qjr xbn rpt
jms: rvh kfr tqc
vtx: hrt nqj qmz ccv
ttq: smr xbb vmc kbx
nbx: dln
xds: bfr zkr lpn jsn
gxb: xnf vrh
jcp: dsm
ppl: mjx
qft: nrd pnc xkc lnp
btq: vzp
ffq: fbj xzm ctp kvc
ggj: nrd
zmq: xsv
clp: qlq pdc drp sxl jpp
rxv: kck
mzd: zbc bkm ggj
cxz: zhd sxc
rnj: mjg snl tfm sgm
rkk: mst jqj fcq dsd
npr: gdq njb
kbj: bdx cmf gxk zdx
scq: dqd gtt xgc cdx kck
zrb: qsx
jnx: xdf cdq
bzs: rks djj
msk: rzk lhv rdd
rtp: zrj lnq
vdk: bfr bcv khp cqr
cdl: jsn zgt rbg ddv
fvb: pzt rfs
mjm: vjd tgv mxp hcd
mbs: mkb
ntc: vbs crp
ghg: mxz jhc zjr
mqx: frs phg bgh
csx: bpx tbn snl
vqq: zqm psr
tmm: htt zzk vrh
fbt: lcb
nvj: ccs rmg
mzt: fgs gxb nbx pxm
ntz: tqf
llr: fhg dpk lqk
xhs: qmm
mmr: nrm
bdl: krr bzk
kmt: jhh
vmf: tjh nhj qbd
zzb: ckp zgl
dqp: bgm zzb
jmd: rxv djj
trh: vql jxj